951515553
AFAFAFFFA
AFEF857FA
AFFFAFFFA
853FAFD52
83AFAFFFE
C44545557

0, 0
8, 6
EEEESSSSSSEEEE
